#####################################################################################################
S     #     #   #             #     #       # #     #         #         #         #               # #
##### # ### # # ########### # # # # ##### # # # ### # ### ### # ### # ### ### ### # ##### ####### # #
#   # #   #   #           # # # # #       #   # # #   # #   # # #   # #   # # #   # #     #   #     #
# # # ### ############### # # # # ### ######### # ##### ### # # # ##### ### # # ##### # ### # ##### #
# # # #   #   #         #   # # # #   #         #         # # # # #         # #     # # #   #     # #
# # # # ### # # # ########### ### ##### ######### ####### # ### # # ######### ##### # ### ####### # #
# #   #     # # # #       #   #   #   # #       # #       # #   # # # #       #   # #   # #     # # #
# ##### ##### # # # ### ### ### # # # # ##### # # # ##### # # ### # # # ####### ### ### # # ### # ###
# #   # #   # # #     #   #   # # # # #     # #   #     # #   #   # # # #     #   #   # # #   # #   #
# ### # ### # # ######### ### # # # # ##### ########### ####### # # # # # ### # # ### # # # # ##### #
#   #     # # # # #         # # # # #     #     #     # #       # #   # #   # # #   # # # # #   #   #
### ##### # # # # # ######### # ### ##### ##### # ### # # ### ####### # # # ### ### # # # ##### # # #
# #     #   # #   #   #       #     #   #   # #   # # # # # # #     # # # #       # #   # #   # # # #
# ##### ### # ##### # # ########### # ### # # ##### # # # # # # ### # # # ####### # ### # # # # # ###
#     #   # #     # #             #   #   #   #     #   # #   #   # # # # #   #   #     # # #   #   #
# # ##### ##### # ############### ### # ####### # ##### # ####### # # # ### # # ######### # ### ### #
# #     #     # #   #     #     # # # #       # # #   # # #   #   #   # #   # #   #         #     # #
####### ##### # ### # ### # ### # # # ####### # # # # # # # # # ####### # ### ##### ############### #
#     #   #   #   # # # # #   #   #     #     # # # #   #   # # #     #     #     # # #           # #
# ### ### # ####### # # # ### ########### ### # # # ######### # # # ############# # # # ######### # #
#   #     # #       # # # #           #   #   # # # #   #   #   # # #           #     #       #   # #
# # ##### # # ### ### # # ########### # ### ### # # # ### # ##### ### ######### ######### ### ### # #
# # #     # # #   #   # # #   #   #     #   #   # # #     #         # #       # #       #   #   # # #
### ####### # ##### ### # # # # # ##### ##### ### # # ############# # # ##### # # ##### ####### # # #
#   #       # #   # #   # # #   #     # #   # #   # #       #   #   # # #     #   #   #     #   # # #
# ### ####### # # # # ### # ######### ### # # # # # ##### ### # # # # # ########### # ##### # ### # #
# #   #     #   #   # #   # #       #     # # # # # #   # #   #   # # # #           #     #   # # # #
# # ### # # ##### ### # ### # ### ######### # # ### # # ### ######### # # ####### ####### ##### # # #
# #   # # # #   # #   #     #   # #       # # #   #   # #   #         #   #     #   #   #       #   #
# ### ### # # # # # # ######### ### ### # # # ### ##### # ### # ########### ### # # # # # ######### #
#   #     #   # # # # #       #     #   # #   #   #   # # #   # #     #       # # # # # # #       # #
# # ########### # ### # # ### # ##### ### ##### # # # # # # ##### ### # ####### # # # # ### ##### # #
# #     #       #   #   # #   #     #   #     # # # #   # #     # #   # #       # # # #       # #   #
# ##### # ######### ##### # ##### ##### ####### ### ##### ##### # # ### # ####### # # ####### # #####
# #     #   #     #   #   # #     #     #   #   #   #   #     #   #   # #   #   # # #   #   #   #   #
### ### ### # ### ### # ### ##### # ##### # # ### ### # # ########### # ### # # # # ### # # ### ### #
#   #     # # #   # #   #       # #   #   # #   # #   # #           #   # # # # # #   # # # #       #
# ### ##### ### # # ### ####### ##### # ### # # # ### # ######### # ##### # # # # ### # # # ####### #
#   # #     #   #   #   #   # # #   # #   # # # #   # #         # #   #   # # # #   #   # #   #   # #
### # # ##### ### ### ### # # # # # # ### # ### ### # ######### ### ### # # # # ######### ### # # # #
#   # #   #   #   #   # # # # #   #   #   # #     #   # #     #   #     # #   #         # #   # # # #
# ### ### # ##### # ### # # # ####### # ### # # ####### # ### ### # ##### ####### ##### # # ### # # #
# #     # # #   # #     # # #     #   #   #   # #       # # #     #   #   #     # #   # # #   # # # #
# ##### # # # # ### ##### # ### # # ##### ##### # ### # # # ####### ### ### ### ### # # # ### # # ###
# #   # # # # #     #     # #   # # #   #     # # #   # # # #       #   #   #   #   #   #   # # #   #
# # # ### # # ##### # ##### # ### # # ####### ### # ##### # # ####### ### ### ### ##### ### # # ### #
#   # #   #   #   # # # #   #   # # #       #   # #     # #   #   #   #   #       #   # #   #   # # #
##### # ### ### # ### # # ##### ### # ### # ### # ##### # # ### # # # # ########### ### # ####### # #
#     # # # #   #     # # #     #   #   # #   #   #     # #   # #   # #   #       # #   #         # #
# ### # # # # ######### # # ##### ### ### ### ##### ##### # ### ##### ### # ##### # # ########### # #
#   # # #   #     #     # #     #   # #   # # #   # #     # #   #       #   #     #   #         # # #
# # ### ##### ### # # # # ### # ### # # ### # # ### # ####### ####### ####### ##### ### # ####### # #
# #   # #   # #   # # # #   # #   # # # #   # # #   # #     #   #   # #     # #     #   #         # #
# ### # # # ### ##### # ### # ### # ### # ### # # ### # # # ### # # ### ### # # ##### ##### ####### #
#   # #   #     #     #   # # #   #     #   # # #   # # # #     # #     # #   #   # # #   #     # # #
# ### ############# ### ### # # ########### # # ### # ### ### ### ####### ####### # # # # ##### # # #
# #   #             # # #   # #       #     #   #   #     # # #   #         #   #   # # #   #     # #
# # ### # ### ####### # # ########### # # ##### # ######### # # # ####### ### # # ### # ### ####### #
# #     #   # #   #     # #         # # #     # #           # # # #     #     #   #   #   #   #   # #
######### # ### # ##### # # ####### # # ##### # ######### # # # ### ### ##### ##### ##### ### # # # #
#       # #     #     # # # #     # #   # #   # #   #   # #   # #   #   #   #     #     # # # # #   #
# ##### # ########### ### # # ##### # ### # ### ### # # # ##### # ### # # # ### ##### ### # # # ### #
#   # # # #   #   #   #   # # #   # #     #         # # # #   #   #   # # #   # #     #   # #   #   #
# # # # ### # # # # # # ### # # # # ######### ####### # # # ####### ### # ### # # ##### ### ##### ###
# # #     # #   # # # #     # # # #         #   #   # # #   #     #   # #   # # # #   # # #         #
# # ##### # ##### # ######### # # ######### # ### # # # ##### ### ### ##### # ### ### # # # #########
# #     # #   # #   #         # #   #     # # #   #   #       # #   #   #   # #   #   # # # # #     #
# ##### # ### # # ### # ####### # ### ### # ### ############### ### ### # ### # ### ### # # # # ### #
#   # # #     #   #   # #   #   #   # #   #   # # #           #   #   #   #   # #   #   #     #   # #
### # # ########### ### # # # ##### # # ##### # # # # ####### # # ### # ### # # ### # ########### # #
#     # #             #   # #   # #   #     #   #   #     # #   #   # #   # # #     #         #   # #
# ##### # ################# ### # ####### # ##### ####### # ####### # ##### ####### ######### # ### #
#   #   # #       #     #     # #   #     #     # #   #   #       # #     #       #     #   # # # # #
##### ### # ####### ### # ##### # # # ######### # # ### ######### # ##### # # ##### ##### # # # # # #
#     #   # #     # #   #     # # # #     #     # #   #     #   # #     # # #       #     # #     # #
# ### # ### # ### # ### ### # # # # ##### ####### # # ##### # # # ##### # ########### ##### ####### #
#   # # #   # # # #   #   # # #   #     #     #   # #     #   # #   #   #       #     # #   #       #
# # ### # ### # # ### ### ### ######### ##### # ####### # ##### # ### ######### # ##### # ### ##### #
# #   #   #   # #   # #         #     # # #   # #       #   #   #   #   #     # # #     #     #   # #
# ### ### # ### ### # ####### ### # # # # # ### # # ####### # ##### ### # ### # # ##### ####### # # #
#   #     #   #     #     #   #   # # # # #   # # #   #   # #     #     #   #   # #   #         # # #
# ########### # ######### # ### ### ### # ### # ##### # # # ##### ### ##### ##### # # # ####### ### #
# #           # #         #   # #   #       # #   #   # # #   # #   # #   # # #     # # #     #     #
# # # ######### # ####### ##### # ### ####### ### # ##### ### # ### ### # # # # ##### # # ### #######
# # # #   #   #   # #     #     #       #     # # # #       # #   # #   #   # #     # # # # #   #   #
# # ### # # # ##### # ##### ############# ### # # # ### ### # ### # # ####### ##### # ### # ### # # #
# #     # # #   #         # # #           #     # #   #   # #   # # # #   #     #   #         # # # #
# ####### # ### ########### # # ########### ##### ### # # # ### # # # # # # # ### ########### # # # #
#   #   #   #   #         #   # #   #   #   #   #     # # # # # # #   # #   # #   #   #   #   #   # #
### # # ##### ### ####### ### # # # ### # ### # ######### # # # # ####### ### # ### # # # # ####### #
#   # #   # #   #   # #   #   # # #   #   #   # #         #   #   #     # #   #     # # # #   #   # #
# ##### # # ### ### # # ### ### # ### ##### ### # ### ####### ### ### # ### # ### ##### # ### # # # #
# #     # #   #   #   #   # # #   # # #       # # #   #   # # #   #   #   # #   # #     # #   # #   #
# # ##### # ### ##### ### # # ##### # # ####### # # ### # # # # ### ##### # # ### # ##### ##### ### #
# # #   # #   #   #   # # #   #     #   #   #   # #   # # #   # #   #     # # #   # #   #       # # #
# # # ### ### ### # ### # ### # ########### # ### ### # # ##### # ### ##### ### ### ### ######### # #
# # #   #   #   # # #   # #   #             #   #   # # # #   #   # #     #       #   #     #   #   #
# # # # ### ### # # # # # # ######### ##### ### ### # # # # # ##### ##### ########### # ### # # # ###
#   # #         #     # #             #       #     #   #   #                         #   #   #     E
#####################################################################################################
