###################################################
S #         #   #                     #     #     #
# ### # ##### # # # ####### ######### # ### # # # #
#   # # #   # #   #     #   #   #     #   #   # # #
### # ### # # ######### ##### # ######### ##### # #
# # #   # #   #     #   #     #           #   # # #
# # # # # ##### # ### # # ##### ######### ### # ###
# # # #         # #   # # #   # #   #   #     #   #
# # # ####### ##### ##### # # ### # # # ##### ### #
# # #   #   # #   #       # #   # #   # #   # #   #
# # # ### # # # # ### ##### ### # ##### # # # # # #
# # # #   # # # #   # #     # #   #   # # #   # # #
# # ### ### ### ### # # ##### ####### # # ##### ###
# #   # #     # #   # #     #         # # #   #   #
# ### # ##### # # ######### # # ####### # ### ### #
#   # # #   #   #       #   # # #     # # #   #   #
# # # # # # ########### # ##### # ### # # # # # ###
# #   #   #       #   #   #     # # #   #   # #   #
# ############### # ######### # # # ######### ### #
#             #   #         # # #     # #       # #
############# # ### # ##### # ####### # # ####### #
#   #       #   #   # #   #   #       # # #     # #
# # ##### # ##### ### # # ### # ####### # # ### # #
# #       #   #   # # # #   # #   #   #   # # # # #
# ########### ### # # # ##### ### # ### ### # # # #
#   #   #   #   # # # #     # #   #   # #   #     #
# # # # # # ### # # # ##### # # ##### # # #########
# # # #   #   # #   #     #   # #     # # #       #
# # ### ### ### ######### ##### # ### # # # ##### #
# #   #   # #   #         #     # #   # #   #   # #
# ### ##### # ### ####### # ##### ### # ##### # # #
#   #     # #   # #   #   #     #   # # #     # # #
### ##### # ### # # # # ####### ### ### # ##### # #
#   #     #   #   # # # # #   #   #     #     #   #
# ### ####### ####### # # # # ### ########### ### #
# #   #       #       #   # #   #     #     #   # #
# # ### ### # ### ##### ### # # ##### # ### ### ###
# # #     # #   #     # #   # # #   #   # #   #   #
### ##### # ### ##### # # ### ### # ##### ### ### #
#   #   # # #         # # # #     #   #   #   #   #
# ### # # # ########### # # ####### ### # # ### # #
#     # # #         #   # #   #     #   #   #   # #
# ##### ########### # ### ### # ### # ####### #####
#     # #   #     #     #   # #   # # #   #   #   #
# ##### # # # ### ######### # ### # # ### # # # # #
# #     # # # #   #   #   #     # # #   #   #   # #
# # ##### # # # ### # # # ##### # ##### ### ##### #
# # #     # # #   # # # #       #     #   #     # #
# # # ##### # ### # # # ############# ### ####### #
# #       #     #   #               #             E
###################################################
