#########################
S   #       #   #       #
### ##### # # # # # ### #
# #       #   # # # # # #
# ############# # # # # #
#         #     # # # # #
# ### ##### ####### # # #
# #   #   # #     # #   #
# ### # # # # ### # # ###
#   # # # #   #   # # # #
# # # # # ##### ### # # #
# # # # #     # #   #   #
# # ### # # ### # ##### #
# # #   # # #   # #   # #
### # ### ### ### # ### #
#   #   #   #     # #   #
# ### ##### ####### # ###
#   # #         #   # # #
# # # # ####### ### # # #
# # # #       #     #   #
# # # ####### ######### #
# #   #       #     #   #
# ##### ####### ### # ###
#     #           #     E
#########################
