###########
S #       #
# ### # ###
#   # #   #
### ### # #
# #   # # #
# ### ### #
#   #   # #
# # ### # #
# #       E
###########
